WWWWWWWWWWWWWWWWWWWWWWWW
W    LLLLL             W
W     LLLLL    B       W
W      LLL             W
W        L         T   W
W                      W
W   B                  W
W         P            W
WWWWWWWWWWWWWWWWWWWWWWWW